0000000000000000000
0000000000000000000
0000000000000000000
0000000000000000000
0000000000000000001
0000000000000110001
0000000000000000001
1000001110000000001
1000000000000000001
1000000000000000001
1111111111111111111